Barista,Patron,Enter,Cost,Exit,Line,Final Cost
0,1,1,3,4,queue,3
0,2,2,3,7,queue,5
0,3,3,3,10,queue,7
0,4,4,3,13,queue,9
0,5,5,3,16,queue,11
0,6,5,3,19,queue,14
0,7,6,3,22,queue,16
0,8,8,3,25,queue,17
0,9,8,3,28,queue,20
0,10,9,3,31,queue,22
0,11,10,3,34,queue,24
0,12,11,3,37,queue,26
0,13,12,3,40,queue,28
0,14,13,3,43,queue,30
0,15,14,3,46,queue,32
0,16,15,3,49,queue,34
0,17,16,3,52,queue,36
0,18,17,3,55,queue,38
0,19,18,3,58,queue,40
0,20,18,3,61,queue,43
0,21,20,3,64,queue,44
0,22,20,3,67,queue,47
0,23,21,3,70,queue,49
0,24,22,3,73,queue,51
0,25,23,3,76,queue,53
0,26,24,3,79,queue,55
0,27,25,3,82,queue,57
0,28,26,3,85,queue,59
0,29,27,3,88,queue,61
0,30,28,3,91,queue,63
0,31,29,3,94,queue,65
0,32,30,3,97,queue,67
0,33,31,3,100,queue,69
0,34,32,3,103,queue,71
0,35,32,3,106,queue,74
0,36,33,3,109,queue,76
0,37,35,3,112,queue,77
0,38,35,3,115,queue,80
0,39,36,3,118,queue,82
0,40,37,3,121,queue,84
0,41,38,3,124,queue,86
0,42,39,3,127,queue,88
0,43,40,3,130,queue,90
0,44,41,3,133,queue,92
0,45,42,3,136,queue,94
0,46,43,3,139,queue,96
0,47,44,3,142,queue,98
0,48,45,3,145,queue,100
0,49,45,3,148,queue,103
0,50,47,3,151,queue,104
0,51,47,3,154,queue,107
0,52,48,3,157,queue,109
0,53,49,3,160,queue,111
0,54,50,3,163,queue,113
0,55,51,3,166,queue,115
0,56,52,3,169,queue,117
0,57,53,3,172,queue,119
0,58,54,3,175,queue,121
0,59,55,3,178,queue,123
0,60,56,3,181,queue,125
0,61,57,3,184,queue,127
0,62,58,3,187,queue,129
0,63,59,3,190,queue,131
0,64,59,3,193,queue,134
0,65,60,3,196,queue,136
0,66,62,3,199,queue,137
0,67,62,3,202,queue,140
0,68,63,3,205,queue,142
0,69,64,3,208,queue,144
0,70,65,3,211,queue,146
0,71,66,3,214,queue,148
0,72,67,3,217,queue,150
0,73,68,3,220,queue,152
0,74,69,3,223,queue,154
0,75,70,3,226,queue,156
0,76,71,3,229,queue,158
0,77,72,3,232,queue,160
0,78,72,3,235,queue,163
0,79,74,3,238,queue,164
0,80,74,3,241,queue,167
0,81,75,3,244,queue,169
0,82,76,3,247,queue,171
0,83,77,3,250,queue,173
0,84,78,3,253,queue,175
0,85,79,3,256,queue,177
0,86,80,3,259,queue,179
0,87,81,3,262,queue,181
0,88,82,3,265,queue,183
0,89,83,3,268,queue,185
0,90,84,3,271,queue,187
0,91,85,3,274,queue,189
0,92,86,3,277,queue,191
0,93,86,3,280,queue,194
0,94,87,3,283,queue,196
0,95,89,3,286,queue,197
0,96,89,3,289,queue,200
0,97,90,3,292,queue,202
0,98,91,3,295,queue,204
0,99,92,3,298,queue,206
0,100,93,3,301,queue,208
0,101,94,3,304,queue,210
0,102,95,3,307,queue,212
0,103,96,3,310,queue,214
0,104,97,3,313,queue,216
0,105,98,3,316,queue,218
0,106,99,3,319,queue,220
0,107,99,3,322,queue,223
0,108,101,3,325,queue,224
0,109,101,3,328,queue,227
0,110,102,3,331,queue,229
0,111,103,3,334,queue,231
0,112,104,3,337,queue,233
0,113,105,3,340,queue,235
0,114,106,3,343,queue,237
0,115,107,3,346,queue,239
0,116,108,3,349,queue,241
0,117,109,3,352,queue,243
0,118,110,3,355,queue,245
0,119,111,3,358,queue,247
0,120,112,3,361,queue,249
0,121,113,3,364,queue,251
0,122,113,3,367,queue,254
0,123,114,3,370,queue,256
0,124,116,3,373,queue,257
0,125,116,3,376,queue,260
0,126,117,3,379,queue,262
0,127,118,3,382,queue,264
0,128,119,3,385,queue,266
0,129,120,3,388,queue,268
0,130,121,3,391,queue,270
0,131,122,3,394,queue,272
0,132,123,3,397,queue,274
0,133,124,3,400,queue,276
0,134,125,3,403,queue,278
0,135,126,3,406,queue,280
0,136,126,3,409,queue,283
0,137,128,3,412,queue,284
0,138,128,3,415,queue,287
0,139,129,3,418,queue,289
0,140,130,3,421,queue,291
0,141,131,3,424,queue,293
0,142,132,3,427,queue,295
0,143,133,3,430,queue,297
0,144,134,3,433,queue,299
0,145,135,3,436,queue,301
0,146,136,3,439,queue,303
0,147,137,3,442,queue,305
0,148,138,3,445,queue,307
0,149,139,3,448,queue,309
0,150,140,3,451,queue,311
0,151,140,3,454,queue,314
0,152,141,3,457,queue,316
0,153,143,3,460,queue,317
0,154,143,3,463,queue,320
0,155,144,3,466,queue,322
0,156,145,3,469,queue,324
0,157,146,3,472,queue,326
0,158,147,3,475,queue,328
0,159,148,3,478,queue,330
0,160,149,3,481,queue,332
0,161,150,3,484,queue,334
0,162,151,3,487,queue,336
0,163,152,3,490,queue,338
0,164,153,3,493,queue,340
0,165,153,3,496,queue,343
0,166,155,3,499,queue,344
0,167,155,3,502,queue,347
0,168,156,3,505,queue,349
0,169,157,3,508,queue,351
0,170,158,3,511,queue,353
0,171,159,3,514,queue,355
0,172,160,3,517,queue,357
0,173,161,3,520,queue,359
0,174,162,3,523,queue,361
0,175,163,3,526,queue,363
0,176,164,3,529,queue,365
0,177,165,3,532,queue,367
0,178,166,3,535,queue,369
0,179,167,3,538,queue,371
0,180,167,3,541,queue,374
0,181,168,3,544,queue,376
0,182,170,3,547,queue,377
0,183,170,3,550,queue,380
0,184,171,3,553,queue,382
0,185,172,3,556,queue,384
0,186,173,3,559,queue,386
0,187,174,3,562,queue,388
0,188,175,3,565,queue,390
0,189,176,3,568,queue,392
0,190,177,3,571,queue,394
0,191,178,3,574,queue,396
0,192,179,3,577,queue,398
0,193,180,3,580,queue,400
0,194,180,3,583,queue,403
0,195,182,3,586,queue,404
0,196,182,3,589,queue,407
0,197,183,3,592,queue,409
0,198,184,3,595,queue,411
0,199,185,3,598,queue,413
0,200,186,3,601,queue,415
0,201,187,3,604,queue,417
0,202,188,3,607,queue,419
0,203,189,3,610,queue,421
0,204,190,3,613,queue,423
0,205,191,3,616,queue,425
0,206,192,3,619,queue,427
0,207,193,3,622,queue,429
0,208,194,3,625,queue,431
0,209,194,3,628,queue,434
0,210,195,3,631,queue,436
0,211,197,3,634,queue,437
0,212,197,3,637,queue,440
0,213,198,3,640,queue,442
0,214,199,3,643,queue,444
0,215,200,3,646,queue,446
0,216,201,3,649,queue,448
1,217,1,3,4,line,3
1,218,2,3,7,line,5
1,219,3,3,10,line,7
1,220,4,3,13,line,9
1,221,6,3,16,line,10
1,222,7,3,19,line,12
1,223,7,3,22,line,15
1,224,9,3,25,line,16
1,225,10,3,28,line,18
1,226,11,3,31,line,20
1,227,12,3,34,line,22
1,228,13,3,37,line,24
1,229,14,3,40,line,26
1,230,15,3,43,line,28
1,231,16,3,46,line,30
1,232,17,3,49,line,32
1,233,19,3,52,line,33
1,234,19,3,55,line,36
1,235,21,3,58,line,37
1,236,22,3,61,line,39
1,237,23,3,64,line,41
1,238,24,3,67,line,43
1,239,25,3,70,line,45
1,240,26,3,73,line,47
1,241,27,3,76,line,49
1,242,28,3,79,line,51
1,243,29,3,82,line,53
1,244,30,3,85,line,55
1,245,31,3,88,line,57
1,246,33,3,91,line,58
1,247,34,3,94,line,60
1,248,34,3,97,line,63
1,249,36,3,100,line,64
1,250,37,3,103,line,66
1,251,38,3,106,line,68
1,252,39,3,109,line,70
1,253,40,3,112,line,72
1,254,41,3,115,line,74
1,255,42,3,118,line,76
1,256,43,3,121,line,78
1,257,44,3,124,line,80
1,258,46,3,127,line,81
1,259,46,3,130,line,84
1,260,48,3,133,line,85
1,261,49,3,136,line,87
1,262,50,3,139,line,89
1,263,51,3,142,line,91
1,264,52,3,145,line,93
1,265,53,3,148,line,95
1,266,54,3,151,line,97
1,267,55,3,154,line,99
1,268,56,3,157,line,101
1,269,57,3,160,line,103
1,270,58,3,163,line,105
1,271,60,3,166,line,106
1,272,61,3,169,line,108
1,273,61,3,172,line,111
1,274,63,3,175,line,112
1,275,64,3,178,line,114
1,276,65,3,181,line,116
1,277,66,3,184,line,118
1,278,67,3,187,line,120
1,279,68,3,190,line,122
1,280,69,3,193,line,124
1,281,70,3,196,line,126
1,282,71,3,199,line,128
1,283,73,3,202,line,129
1,284,73,3,205,line,132
1,285,75,3,208,line,133
1,286,76,3,211,line,135
1,287,77,3,214,line,137
1,288,78,3,217,line,139
1,289,79,3,220,line,141
1,290,80,3,223,line,143
1,291,81,3,226,line,145
1,292,82,3,229,line,147
1,293,83,3,232,line,149
1,294,84,3,235,line,151
1,295,85,3,238,line,153
1,296,87,3,241,line,154
1,297,88,3,244,line,156
1,298,88,3,247,line,159
1,299,90,3,250,line,160
1,300,91,3,253,line,162
1,301,92,3,256,line,164
1,302,93,3,259,line,166
1,303,94,3,262,line,168
1,304,95,3,265,line,170
1,305,96,3,268,line,172
1,306,97,3,271,line,174
1,307,98,3,274,line,176
1,308,100,3,277,line,177
1,309,100,3,280,line,180
1,310,102,3,283,line,181
1,311,103,3,286,line,183
1,312,104,3,289,line,185
1,313,105,3,292,line,187
1,314,106,3,295,line,189
1,315,107,3,298,line,191
1,316,108,3,301,line,193
1,317,109,3,304,line,195
1,318,110,3,307,line,197
1,319,111,3,310,line,199
1,320,112,3,313,line,201
1,321,114,3,316,line,202
1,322,115,3,319,line,204
1,323,115,3,322,line,207
1,324,117,3,325,line,208
1,325,118,3,328,line,210
1,326,119,3,331,line,212
1,327,120,3,334,line,214
1,328,121,3,337,line,216
1,329,122,3,340,line,218
1,330,123,3,343,line,220
1,331,124,3,346,line,222
1,332,125,3,349,line,224
1,333,127,3,352,line,225
1,334,127,3,355,line,228
1,335,129,3,358,line,229
1,336,130,3,361,line,231
1,337,131,3,364,line,233
1,338,132,3,367,line,235
1,339,133,3,370,line,237
1,340,134,3,373,line,239
1,341,135,3,376,line,241
1,342,136,3,379,line,243
1,343,137,3,382,line,245
1,344,138,3,385,line,247
1,345,139,3,388,line,249
1,346,141,3,391,line,250
1,347,142,3,394,line,252
1,348,142,3,397,line,255
1,349,144,3,400,line,256
1,350,145,3,403,line,258
1,351,146,3,406,line,260
1,352,147,3,409,line,262
1,353,148,3,412,line,264
1,354,149,3,415,line,266
1,355,150,3,418,line,268
1,356,151,3,421,line,270
1,357,152,3,424,line,272
1,358,154,3,427,line,273
1,359,154,3,430,line,276
1,360,156,3,433,line,277
1,361,157,3,436,line,279
1,362,158,3,439,line,281
1,363,159,3,442,line,283
1,364,160,3,445,line,285
1,365,161,3,448,line,287
1,366,162,3,451,line,289
1,367,163,3,454,line,291
1,368,164,3,457,line,293
1,369,165,3,460,line,295
1,370,166,3,463,line,297
1,371,168,3,466,line,298
1,372,169,3,469,line,300
1,373,169,3,472,line,303
1,374,171,3,475,line,304
1,375,172,3,478,line,306
1,376,173,3,481,line,308
1,377,174,3,484,line,310
1,378,175,3,487,line,312
1,379,176,3,490,line,314
1,380,177,3,493,line,316
1,381,178,3,496,line,318
1,382,179,3,499,line,320
1,383,181,3,502,line,321
1,384,181,3,505,line,324
1,385,183,3,508,line,325
1,386,184,3,511,line,327
1,387,185,3,514,line,329
1,388,186,3,517,line,331
1,389,187,3,520,line,333
1,390,188,3,523,line,335
1,391,189,3,526,line,337
1,392,190,3,529,line,339
1,393,191,3,532,line,341
1,394,192,3,535,line,343
1,395,193,3,538,line,345
1,396,195,3,541,line,346
1,397,196,3,544,line,348
1,398,196,3,547,line,351
1,399,198,3,550,line,352
1,400,199,3,553,line,354
1,401,200,3,556,line,356
1,402,201,3,559,line,358
