Barista,Patron,Enter,Cost,Exit,Line,Final Cost
0,1,1,3,4,queue,3
0,2,2,3,7,queue,5
0,3,3,3,10,queue,7
0,4,3,3,13,queue,10
0,5,4,3,16,queue,12
0,6,5,3,19,queue,14
0,7,6,3,22,queue,16
0,8,6,3,25,queue,19
0,9,7,3,28,queue,21
0,10,8,3,31,queue,23
0,11,9,3,34,queue,25
0,12,9,3,37,queue,28
0,13,10,3,40,queue,30
0,14,11,3,43,queue,32
0,15,12,3,46,queue,34
0,16,12,3,49,queue,37
0,17,13,3,52,queue,39
0,18,13,3,55,queue,42
0,19,14,3,58,queue,44
0,20,15,3,61,queue,46
0,21,16,3,64,queue,48
0,22,16,3,67,queue,51
0,23,17,3,70,queue,53
0,24,18,3,73,queue,55
0,25,19,3,76,queue,57
0,26,19,3,79,queue,60
0,27,20,3,82,queue,62
0,28,21,3,85,queue,64
0,29,22,3,88,queue,66
0,30,22,3,91,queue,69
0,31,23,3,94,queue,71
0,32,24,3,97,queue,73
0,33,25,3,100,queue,75
0,34,25,3,103,queue,78
0,35,26,3,106,queue,80
0,36,27,3,109,queue,82
0,37,28,3,112,queue,84
0,38,28,3,115,queue,87
0,39,29,3,118,queue,89
0,40,30,3,121,queue,91
0,41,30,3,124,queue,94
0,42,31,3,127,queue,96
0,43,32,3,130,queue,98
0,44,33,3,133,queue,100
0,45,33,3,136,queue,103
0,46,34,3,139,queue,105
0,47,35,3,142,queue,107
0,48,36,3,145,queue,109
0,49,36,3,148,queue,112
0,50,37,3,151,queue,114
0,51,38,3,154,queue,116
0,52,39,3,157,queue,118
0,53,39,3,160,queue,121
0,54,40,3,163,queue,123
0,55,41,3,166,queue,125
0,56,42,3,169,queue,127
0,57,42,3,172,queue,130
0,58,43,3,175,queue,132
0,59,44,3,178,queue,134
0,60,45,3,181,queue,136
0,61,45,3,184,queue,139
0,62,46,3,187,queue,141
0,63,47,3,190,queue,143
0,64,48,3,193,queue,145
0,65,48,3,196,queue,148
0,66,49,3,199,queue,150
0,67,49,3,202,queue,153
0,68,50,3,205,queue,155
0,69,51,3,208,queue,157
0,70,52,3,211,queue,159
0,71,52,3,214,queue,162
0,72,53,3,217,queue,164
0,73,54,3,220,queue,166
0,74,55,3,223,queue,168
0,75,55,3,226,queue,171
0,76,56,3,229,queue,173
0,77,57,3,232,queue,175
0,78,58,3,235,queue,177
0,79,58,3,238,queue,180
0,80,59,3,241,queue,182
0,81,60,3,244,queue,184
0,82,61,3,247,queue,186
0,83,61,3,250,queue,189
0,84,62,3,253,queue,191
0,85,63,3,256,queue,193
0,86,64,3,259,queue,195
0,87,64,3,262,queue,198
0,88,65,3,265,queue,200
0,89,66,3,268,queue,202
0,90,67,3,271,queue,204
0,91,67,3,274,queue,207
0,92,68,3,277,queue,209
0,93,69,3,280,queue,211
0,94,69,3,283,queue,214
0,95,70,3,286,queue,216
0,96,71,3,289,queue,218
0,97,72,3,292,queue,220
0,98,72,3,295,queue,223
0,99,73,3,298,queue,225
0,100,74,3,301,queue,227
0,101,75,3,304,queue,229
0,102,75,3,307,queue,232
0,103,76,3,310,queue,234
0,104,77,3,313,queue,236
0,105,78,3,316,queue,238
0,106,78,3,319,queue,241
0,107,79,3,322,queue,243
0,108,80,3,325,queue,245
0,109,81,3,328,queue,247
0,110,81,3,331,queue,250
0,111,82,3,334,queue,252
0,112,83,3,337,queue,254
0,113,84,3,340,queue,256
0,114,84,3,343,queue,259
0,115,85,3,346,queue,261
0,116,86,3,349,queue,263
0,117,87,3,352,queue,265
0,118,87,3,355,queue,268
0,119,88,3,358,queue,270
0,120,88,3,361,queue,273
0,121,89,3,364,queue,275
0,122,90,3,367,queue,277
0,123,91,3,370,queue,279
0,124,91,3,373,queue,282
0,125,92,3,376,queue,284
0,126,93,3,379,queue,286
0,127,94,3,382,queue,288
0,128,94,3,385,queue,291
0,129,95,3,388,queue,293
0,130,96,3,391,queue,295
0,131,97,3,394,queue,297
0,132,97,3,397,queue,300
0,133,98,3,400,queue,302
0,134,99,3,403,queue,304
0,135,100,3,406,queue,306
0,136,100,3,409,queue,309
0,137,101,3,412,queue,311
0,138,102,3,415,queue,313
0,139,103,3,418,queue,315
0,140,103,3,421,queue,318
0,141,104,3,424,queue,320
0,142,105,3,427,queue,322
0,143,106,3,430,queue,324
0,144,106,3,433,queue,327
0,145,107,3,436,queue,329
0,146,108,3,439,queue,331
0,147,108,3,442,queue,334
0,148,109,3,445,queue,336
0,149,110,3,448,queue,338
0,150,111,3,451,queue,340
0,151,111,3,454,queue,343
0,152,112,3,457,queue,345
0,153,113,3,460,queue,347
0,154,114,3,463,queue,349
0,155,114,3,466,queue,352
0,156,115,3,469,queue,354
0,157,116,3,472,queue,356
0,158,117,3,475,queue,358
0,159,117,3,478,queue,361
0,160,118,3,481,queue,363
0,161,119,3,484,queue,365
0,162,120,3,487,queue,367
0,163,120,3,490,queue,370
0,164,121,3,493,queue,372
0,165,122,3,496,queue,374
0,166,123,3,499,queue,376
0,167,123,3,502,queue,379
0,168,124,3,505,queue,381
0,169,125,3,508,queue,383
0,170,126,3,511,queue,385
0,171,126,3,514,queue,388
0,172,127,3,517,queue,390
0,173,127,3,520,queue,393
0,174,128,3,523,queue,395
0,175,129,3,526,queue,397
0,176,130,3,529,queue,399
0,177,130,3,532,queue,402
0,178,131,3,535,queue,404
0,179,132,3,538,queue,406
0,180,133,3,541,queue,408
0,181,133,3,544,queue,411
0,182,134,3,547,queue,413
0,183,135,3,550,queue,415
0,184,136,3,553,queue,417
0,185,136,3,556,queue,420
0,186,137,3,559,queue,422
0,187,138,3,562,queue,424
0,188,139,3,565,queue,426
0,189,139,3,568,queue,429
0,190,140,3,571,queue,431
0,191,141,3,574,queue,433
0,192,142,3,577,queue,435
0,193,142,3,580,queue,438
0,194,143,3,583,queue,440
0,195,144,3,586,queue,442
0,196,145,3,589,queue,444
0,197,145,3,592,queue,447
0,198,146,3,595,queue,449
0,199,147,3,598,queue,451
0,200,148,3,601,queue,453
0,201,148,3,604,queue,456
0,202,149,3,607,queue,458
0,203,150,3,610,queue,460
0,204,150,3,613,queue,463
0,205,151,3,616,queue,465
0,206,152,3,619,queue,467
0,207,153,3,622,queue,469
0,208,153,3,625,queue,472
0,209,154,3,628,queue,474
0,210,155,3,631,queue,476
0,211,156,3,634,queue,478
0,212,156,3,637,queue,481
0,213,157,3,640,queue,483
0,214,158,3,643,queue,485
0,215,159,3,646,queue,487
0,216,159,3,649,queue,490
0,217,160,3,652,queue,492
0,218,161,3,655,queue,494
0,219,162,3,658,queue,496
0,220,162,3,661,queue,499
0,221,163,3,664,queue,501
0,222,164,3,667,queue,503
0,223,165,3,670,queue,505
0,224,165,3,673,queue,508
0,225,166,3,676,queue,510
0,226,166,3,679,queue,513
0,227,167,3,682,queue,515
0,228,168,3,685,queue,517
0,229,169,3,688,queue,519
0,230,169,3,691,queue,522
0,231,170,3,694,queue,524
0,232,171,3,697,queue,526
0,233,172,3,700,queue,528
0,234,172,3,703,queue,531
0,235,173,3,706,queue,533
0,236,174,3,709,queue,535
0,237,175,3,712,queue,537
0,238,175,3,715,queue,540
0,239,176,3,718,queue,542
0,240,177,3,721,queue,544
0,241,178,3,724,queue,546
0,242,178,3,727,queue,549
0,243,179,3,730,queue,551
0,244,180,3,733,queue,553
0,245,181,3,736,queue,555
0,246,181,3,739,queue,558
0,247,182,3,742,queue,560
0,248,183,3,745,queue,562
0,249,184,3,748,queue,564
0,250,184,3,751,queue,567
0,251,185,3,754,queue,569
0,252,186,3,757,queue,571
0,253,186,3,760,queue,574
0,254,187,3,763,queue,576
0,255,188,3,766,queue,578
0,256,189,3,769,queue,580
0,257,189,3,772,queue,583
0,258,190,3,775,queue,585
0,259,191,3,778,queue,587
0,260,192,3,781,queue,589
0,261,192,3,784,queue,592
0,262,193,3,787,queue,594
0,263,194,3,790,queue,596
0,264,195,3,793,queue,598
0,265,195,3,796,queue,601
0,266,196,3,799,queue,603
0,267,197,3,802,queue,605
0,268,198,3,805,queue,607
0,269,198,3,808,queue,610
0,270,199,3,811,queue,612
0,271,200,3,814,queue,614
0,272,201,3,817,queue,616
0,273,201,3,820,queue,619
0,274,202,3,823,queue,621
0,275,203,3,826,queue,623
0,276,204,3,829,queue,625
0,277,204,3,832,queue,628
0,278,205,3,835,queue,630
0,279,205,3,838,queue,633
0,280,206,3,841,queue,635
0,281,207,3,844,queue,637
0,282,208,3,847,queue,639
0,283,208,3,850,queue,642
0,284,209,3,853,queue,644
0,285,210,3,856,queue,646
0,286,211,3,859,queue,648
0,287,211,3,862,queue,651
0,288,212,3,865,queue,653
0,289,213,3,868,queue,655
0,290,214,3,871,queue,657
0,291,214,3,874,queue,660
0,292,215,3,877,queue,662
0,293,216,3,880,queue,664
0,294,217,3,883,queue,666
0,295,217,3,886,queue,669
0,296,218,3,889,queue,671
0,297,219,3,892,queue,673
0,298,220,3,895,queue,675
0,299,220,3,898,queue,678
0,300,221,3,901,queue,680
0,301,222,3,904,queue,682
0,302,223,3,907,queue,684
0,303,223,3,910,queue,687
0,304,224,3,913,queue,689
0,305,225,3,916,queue,691
0,306,225,3,919,queue,694
0,307,226,3,922,queue,696
0,308,227,3,925,queue,698
0,309,228,3,928,queue,700
0,310,228,3,931,queue,703
0,311,229,3,934,queue,705
0,312,230,3,937,queue,707
0,313,231,3,940,queue,709
0,314,231,3,943,queue,712
0,315,232,3,946,queue,714
0,316,233,3,949,queue,716
0,317,234,3,952,queue,718
0,318,234,3,955,queue,721
0,319,235,3,958,queue,723
0,320,236,3,961,queue,725
0,321,237,3,964,queue,727
0,322,237,3,967,queue,730
0,323,238,3,970,queue,732
0,324,239,3,973,queue,734
0,325,240,3,976,queue,736
0,326,240,3,979,queue,739
0,327,241,3,982,queue,741
0,328,242,3,985,queue,743
0,329,243,3,988,queue,745
0,330,243,3,991,queue,748
0,331,244,3,994,queue,750
0,332,244,3,997,queue,753
0,333,245,3,1000,queue,755
0,334,246,3,1003,queue,757
0,335,247,3,1006,queue,759
0,336,247,3,1009,queue,762
0,337,248,3,1012,queue,764
0,338,249,3,1015,queue,766
0,339,250,3,1018,queue,768
0,340,250,3,1021,queue,771
0,341,251,3,1024,queue,773
0,342,252,3,1027,queue,775
0,343,253,3,1030,queue,777
0,344,253,3,1033,queue,780
0,345,254,3,1036,queue,782
0,346,255,3,1039,queue,784
0,347,256,3,1042,queue,786
0,348,256,3,1045,queue,789
0,349,257,3,1048,queue,791
0,350,258,3,1051,queue,793
0,351,259,3,1054,queue,795
0,352,259,3,1057,queue,798
0,353,260,3,1060,queue,800
0,354,261,3,1063,queue,802
0,355,262,3,1066,queue,804
0,356,262,3,1069,queue,807
0,357,263,3,1072,queue,809
0,358,264,3,1075,queue,811
0,359,264,3,1078,queue,814
0,360,265,3,1081,queue,816
0,361,266,3,1084,queue,818
0,362,267,3,1087,queue,820
0,363,267,3,1090,queue,823
0,364,268,3,1093,queue,825
0,365,269,3,1096,queue,827
0,366,270,3,1099,queue,829
0,367,270,3,1102,queue,832
0,368,271,3,1105,queue,834
0,369,272,3,1108,queue,836
0,370,273,3,1111,queue,838
0,371,273,3,1114,queue,841
0,372,274,3,1117,queue,843
0,373,275,3,1120,queue,845
0,374,276,3,1123,queue,847
0,375,276,3,1126,queue,850
0,376,277,3,1129,queue,852
0,377,278,3,1132,queue,854
0,378,279,3,1135,queue,856
0,379,279,3,1138,queue,859
0,380,280,3,1141,queue,861
0,381,281,3,1144,queue,863
0,382,282,3,1147,queue,865
0,383,282,3,1150,queue,868
0,384,283,3,1153,queue,870
0,385,284,3,1156,queue,872
0,386,285,3,1159,queue,874
0,387,285,3,1162,queue,877
0,388,286,3,1165,queue,879
0,389,286,3,1168,queue,882
0,390,287,3,1171,queue,884
0,391,288,3,1174,queue,886
0,392,289,3,1177,queue,888
0,393,289,3,1180,queue,891
0,394,290,3,1183,queue,893
0,395,291,3,1186,queue,895
0,396,292,3,1189,queue,897
0,397,292,3,1192,queue,900
0,398,293,3,1195,queue,902
0,399,294,3,1198,queue,904
0,400,295,3,1201,queue,906
0,401,295,3,1204,queue,909
0,402,296,3,1207,queue,911
0,403,297,3,1210,queue,913
0,404,298,3,1213,queue,915
0,405,298,3,1216,queue,918
0,406,299,3,1219,queue,920
0,407,300,3,1222,queue,922
0,408,301,3,1225,queue,924
0,409,301,3,1228,queue,927
0,410,302,3,1231,queue,929
0,411,303,3,1234,queue,931
0,412,304,3,1237,queue,933
0,413,304,3,1240,queue,936
0,414,305,3,1243,queue,938
0,415,306,3,1246,queue,940
0,416,306,3,1249,queue,943
0,417,307,3,1252,queue,945
0,418,308,3,1255,queue,947
0,419,309,3,1258,queue,949
0,420,309,3,1261,queue,952
0,421,310,3,1264,queue,954
0,422,311,3,1267,queue,956
0,423,312,3,1270,queue,958
0,424,312,3,1273,queue,961
0,425,313,3,1276,queue,963
0,426,314,3,1279,queue,965
0,427,315,3,1282,queue,967
0,428,315,3,1285,queue,970
0,429,316,3,1288,queue,972
0,430,317,3,1291,queue,974
0,431,318,3,1294,queue,976
0,432,318,3,1297,queue,979
0,433,319,3,1300,queue,981
0,434,320,3,1303,queue,983
0,435,321,3,1306,queue,985
0,436,321,3,1309,queue,988
0,437,322,3,1312,queue,990
0,438,322,3,1315,queue,993
0,439,323,3,1318,queue,995
0,440,324,3,1321,queue,997
0,441,325,3,1324,queue,999
0,442,325,3,1327,queue,1002
0,443,326,3,1330,queue,1004
0,444,327,3,1333,queue,1006
0,445,328,3,1336,queue,1008
0,446,328,3,1339,queue,1011
0,447,329,3,1342,queue,1013
0,448,330,3,1345,queue,1015
0,449,331,3,1348,queue,1017
0,450,331,3,1351,queue,1020
0,451,332,3,1354,queue,1022
0,452,333,3,1357,queue,1024
0,453,334,3,1360,queue,1026
0,454,334,3,1363,queue,1029
0,455,335,3,1366,queue,1031
0,456,336,3,1369,queue,1033
0,457,337,3,1372,queue,1035
0,458,337,3,1375,queue,1038
0,459,338,3,1378,queue,1040
0,460,339,3,1381,queue,1042
0,461,340,3,1384,queue,1044
0,462,340,3,1387,queue,1047
0,463,341,3,1390,queue,1049
0,464,342,3,1393,queue,1051
0,465,342,3,1396,queue,1054
0,466,343,3,1399,queue,1056
0,467,344,3,1402,queue,1058
0,468,345,3,1405,queue,1060
0,469,345,3,1408,queue,1063
0,470,346,3,1411,queue,1065
0,471,347,3,1414,queue,1067
0,472,348,3,1417,queue,1069
0,473,348,3,1420,queue,1072
0,474,349,3,1423,queue,1074
0,475,350,3,1426,queue,1076
0,476,351,3,1429,queue,1078
0,477,351,3,1432,queue,1081
0,478,352,3,1435,queue,1083
0,479,353,3,1438,queue,1085
0,480,354,3,1441,queue,1087
0,481,354,3,1444,queue,1090
0,482,355,3,1447,queue,1092
0,483,356,3,1450,queue,1094
0,484,357,3,1453,queue,1096
0,485,357,3,1456,queue,1099
0,486,358,3,1459,queue,1101
0,487,359,3,1462,queue,1103
0,488,360,3,1465,queue,1105
0,489,360,3,1468,queue,1108
0,490,361,3,1471,queue,1110
0,491,361,3,1474,queue,1113
0,492,362,3,1477,queue,1115
0,493,363,3,1480,queue,1117
0,494,364,3,1483,queue,1119
0,495,364,3,1486,queue,1122
0,496,365,3,1489,queue,1124
0,497,366,3,1492,queue,1126
0,498,367,3,1495,queue,1128
0,499,367,3,1498,queue,1131
0,500,368,3,1501,queue,1133
0,501,369,3,1504,queue,1135
0,502,370,3,1507,queue,1137
0,503,370,3,1510,queue,1140
0,504,371,3,1513,queue,1142
0,505,372,3,1516,queue,1144
0,506,373,3,1519,queue,1146
0,507,373,3,1522,queue,1149
0,508,374,3,1525,queue,1151
0,509,375,3,1528,queue,1153
0,510,376,3,1531,queue,1155
0,511,376,3,1534,queue,1158
0,512,377,3,1537,queue,1160
0,513,378,3,1540,queue,1162
0,514,379,3,1543,queue,1164
0,515,379,3,1546,queue,1167
0,516,380,3,1549,queue,1169
0,517,381,3,1552,queue,1171
0,518,381,3,1555,queue,1174
0,519,382,3,1558,queue,1176
0,520,383,3,1561,queue,1178
0,521,384,3,1564,queue,1180
0,522,384,3,1567,queue,1183
0,523,385,3,1570,queue,1185
0,524,386,3,1573,queue,1187
0,525,387,3,1576,queue,1189
0,526,387,3,1579,queue,1192
0,527,388,3,1582,queue,1194
0,528,389,3,1585,queue,1196
0,529,390,3,1588,queue,1198
0,530,390,3,1591,queue,1201
0,531,391,3,1594,queue,1203
0,532,392,3,1597,queue,1205
0,533,393,3,1600,queue,1207
0,534,393,3,1603,queue,1210
0,535,394,3,1606,queue,1212
0,536,395,3,1609,queue,1214
0,537,396,3,1612,queue,1216
0,538,396,3,1615,queue,1219
0,539,397,3,1618,queue,1221
0,540,398,3,1621,queue,1223
0,541,399,3,1624,queue,1225
0,542,399,3,1627,queue,1228
0,543,400,3,1630,queue,1230
0,544,400,3,1633,queue,1233
0,545,401,3,1636,queue,1235
0,546,402,3,1639,queue,1237
0,547,403,3,1642,queue,1239
0,548,403,3,1645,queue,1242
0,549,404,3,1648,queue,1244
0,550,405,3,1651,queue,1246
0,551,406,3,1654,queue,1248
0,552,406,3,1657,queue,1251
0,553,407,3,1660,queue,1253
0,554,408,3,1663,queue,1255
0,555,409,3,1666,queue,1257
0,556,409,3,1669,queue,1260
0,557,410,3,1672,queue,1262
0,558,411,3,1675,queue,1264
0,559,412,3,1678,queue,1266
0,560,412,3,1681,queue,1269
0,561,413,3,1684,queue,1271
0,562,414,3,1687,queue,1273
0,563,415,3,1690,queue,1275
0,564,415,3,1693,queue,1278
0,565,416,3,1696,queue,1280
0,566,417,3,1699,queue,1282
0,567,418,3,1702,queue,1284
0,568,418,3,1705,queue,1287
0,569,419,3,1708,queue,1289
0,570,420,3,1711,queue,1291
0,571,420,3,1714,queue,1294
0,572,421,3,1717,queue,1296
0,573,422,3,1720,queue,1298
0,574,423,3,1723,queue,1300
0,575,423,3,1726,queue,1303
0,576,424,3,1729,queue,1305
0,577,425,3,1732,queue,1307
0,578,426,3,1735,queue,1309
0,579,426,3,1738,queue,1312
0,580,427,3,1741,queue,1314
0,581,428,3,1744,queue,1316
0,582,429,3,1747,queue,1318
0,583,429,3,1750,queue,1321
0,584,430,3,1753,queue,1323
0,585,431,3,1756,queue,1325
0,586,432,3,1759,queue,1327
0,587,432,3,1762,queue,1330
0,588,433,3,1765,queue,1332
0,589,434,3,1768,queue,1334
0,590,435,3,1771,queue,1336
0,591,435,3,1774,queue,1339
0,592,436,3,1777,queue,1341
0,593,437,3,1780,queue,1343
0,594,438,3,1783,queue,1345
0,595,438,3,1786,queue,1348
0,596,439,3,1789,queue,1350
0,597,439,3,1792,queue,1353
0,598,440,3,1795,queue,1355
0,599,441,3,1798,queue,1357
0,600,442,3,1801,queue,1359
0,601,442,3,1804,queue,1362
0,602,443,3,1807,queue,1364
0,603,444,3,1810,queue,1366
0,604,445,3,1813,queue,1368
0,605,445,3,1816,queue,1371
0,606,446,3,1819,queue,1373
0,607,447,3,1822,queue,1375
0,608,448,3,1825,queue,1377
0,609,448,3,1828,queue,1380
0,610,449,3,1831,queue,1382
0,611,450,3,1834,queue,1384
0,612,451,3,1837,queue,1386
0,613,451,3,1840,queue,1389
0,614,452,3,1843,queue,1391
0,615,453,3,1846,queue,1393
0,616,454,3,1849,queue,1395
0,617,454,3,1852,queue,1398
0,618,455,3,1855,queue,1400
0,619,456,3,1858,queue,1402
0,620,457,3,1861,queue,1404
0,621,457,3,1864,queue,1407
0,622,458,3,1867,queue,1409
0,623,459,3,1870,queue,1411
0,624,459,3,1873,queue,1414
0,625,460,3,1876,queue,1416
0,626,461,3,1879,queue,1418
0,627,462,3,1882,queue,1420
0,628,462,3,1885,queue,1423
0,629,463,3,1888,queue,1425
0,630,464,3,1891,queue,1427
0,631,465,3,1894,queue,1429
0,632,465,3,1897,queue,1432
0,633,466,3,1900,queue,1434
0,634,467,3,1903,queue,1436
0,635,468,3,1906,queue,1438
0,636,468,3,1909,queue,1441
0,637,469,3,1912,queue,1443
0,638,470,3,1915,queue,1445
0,639,471,3,1918,queue,1447
0,640,471,3,1921,queue,1450
0,641,472,3,1924,queue,1452
0,642,473,3,1927,queue,1454
0,643,474,3,1930,queue,1456
0,644,474,3,1933,queue,1459
0,645,475,3,1936,queue,1461
0,646,476,3,1939,queue,1463
0,647,477,3,1942,queue,1465
0,648,477,3,1945,queue,1468
0,649,478,3,1948,queue,1470
0,650,478,3,1951,queue,1473
0,651,479,3,1954,queue,1475
0,652,480,3,1957,queue,1477
0,653,481,3,1960,queue,1479
0,654,481,3,1963,queue,1482
0,655,482,3,1966,queue,1484
0,656,483,3,1969,queue,1486
0,657,484,3,1972,queue,1488
0,658,484,3,1975,queue,1491
0,659,485,3,1978,queue,1493
0,660,486,3,1981,queue,1495
0,661,487,3,1984,queue,1497
0,662,487,3,1987,queue,1500
0,663,488,3,1990,queue,1502
0,664,489,3,1993,queue,1504
0,665,490,3,1996,queue,1506
0,666,490,3,1999,queue,1509
0,667,491,3,2002,queue,1511
0,668,492,3,2005,queue,1513
0,669,493,3,2008,queue,1515
0,670,493,3,2011,queue,1518
0,671,494,3,2014,queue,1520
0,672,495,3,2017,queue,1522
0,673,496,3,2020,queue,1524
0,674,496,3,2023,queue,1527
0,675,497,3,2026,queue,1529
0,676,498,3,2029,queue,1531
0,677,498,3,2032,queue,1534
0,678,499,3,2035,queue,1536
0,679,500,3,2038,queue,1538
0,680,501,3,2041,queue,1540
0,681,501,3,2044,queue,1543
0,682,502,3,2047,queue,1545
0,683,503,3,2050,queue,1547
0,684,504,3,2053,queue,1549
0,685,504,3,2056,queue,1552
0,686,505,3,2059,queue,1554
0,687,506,3,2062,queue,1556
0,688,507,3,2065,queue,1558
0,689,507,3,2068,queue,1561
0,690,508,3,2071,queue,1563
0,691,509,3,2074,queue,1565
0,692,510,3,2077,queue,1567
0,693,510,3,2080,queue,1570
0,694,511,3,2083,queue,1572
0,695,512,3,2086,queue,1574
0,696,513,3,2089,queue,1576
0,697,513,3,2092,queue,1579
0,698,514,3,2095,queue,1581
0,699,515,3,2098,queue,1583
0,700,516,3,2101,queue,1585
0,701,516,3,2104,queue,1588
0,702,517,3,2107,queue,1590
0,703,517,3,2110,queue,1593
0,704,518,3,2113,queue,1595
0,705,519,3,2116,queue,1597
0,706,520,3,2119,queue,1599
0,707,520,3,2122,queue,1602
0,708,521,3,2125,queue,1604
0,709,522,3,2128,queue,1606
0,710,523,3,2131,queue,1608
0,711,523,3,2134,queue,1611
0,712,524,3,2137,queue,1613
0,713,525,3,2140,queue,1615
0,714,526,3,2143,queue,1617
0,715,526,3,2146,queue,1620
0,716,527,3,2149,queue,1622
0,717,528,3,2152,queue,1624
0,718,529,3,2155,queue,1626
0,719,529,3,2158,queue,1629
0,720,530,3,2161,queue,1631
0,721,531,3,2164,queue,1633
0,722,532,3,2167,queue,1635
0,723,532,3,2170,queue,1638
0,724,533,3,2173,queue,1640
0,725,534,3,2176,queue,1642
0,726,535,3,2179,queue,1644
0,727,535,3,2182,queue,1647
0,728,536,3,2185,queue,1649
0,729,537,3,2188,queue,1651
0,730,537,3,2191,queue,1654
0,731,538,3,2194,queue,1656
0,732,539,3,2197,queue,1658
0,733,540,3,2200,queue,1660
0,734,540,3,2203,queue,1663
0,735,541,3,2206,queue,1665
0,736,542,3,2209,queue,1667
0,737,543,3,2212,queue,1669
0,738,543,3,2215,queue,1672
0,739,544,3,2218,queue,1674
0,740,545,3,2221,queue,1676
0,741,546,3,2224,queue,1678
0,742,546,3,2227,queue,1681
0,743,547,3,2230,queue,1683
0,744,548,3,2233,queue,1685
0,745,549,3,2236,queue,1687
0,746,549,3,2239,queue,1690
0,747,550,3,2242,queue,1692
0,748,551,3,2245,queue,1694
0,749,552,3,2248,queue,1696
0,750,552,3,2251,queue,1699
0,751,553,3,2254,queue,1701
0,752,554,3,2257,queue,1703
0,753,555,3,2260,queue,1705
0,754,555,3,2263,queue,1708
0,755,556,3,2266,queue,1710
0,756,557,3,2269,queue,1712
0,757,558,3,2272,queue,1714
0,758,558,3,2275,queue,1717
0,759,559,3,2278,queue,1719
0,760,559,3,2281,queue,1722
0,761,560,3,2284,queue,1724
0,762,561,3,2287,queue,1726
0,763,562,3,2290,queue,1728
0,764,562,3,2293,queue,1731
0,765,563,3,2296,queue,1733
0,766,564,3,2299,queue,1735
0,767,565,3,2302,queue,1737
0,768,565,3,2305,queue,1740
0,769,566,3,2308,queue,1742
0,770,567,3,2311,queue,1744
0,771,568,3,2314,queue,1746
0,772,568,3,2317,queue,1749
0,773,569,3,2320,queue,1751
0,774,570,3,2323,queue,1753
0,775,571,3,2326,queue,1755
0,776,571,3,2329,queue,1758
0,777,572,3,2332,queue,1760
0,778,573,3,2335,queue,1762
0,779,574,3,2338,queue,1764
0,780,574,3,2341,queue,1767
0,781,575,3,2344,queue,1769
0,782,576,3,2347,queue,1771
0,783,577,3,2350,queue,1773
0,784,577,3,2353,queue,1776
0,785,578,3,2356,queue,1778
0,786,579,3,2359,queue,1780
0,787,579,3,2362,queue,1783
0,788,580,3,2365,queue,1785
0,789,581,3,2368,queue,1787
0,790,582,3,2371,queue,1789
0,791,582,3,2374,queue,1792
0,792,583,3,2377,queue,1794
0,793,584,3,2380,queue,1796
0,794,585,3,2383,queue,1798
0,795,585,3,2386,queue,1801
0,796,586,3,2389,queue,1803
0,797,587,3,2392,queue,1805
0,798,588,3,2395,queue,1807
0,799,588,3,2398,queue,1810
0,800,589,3,2401,queue,1812
0,801,590,3,2404,queue,1814
0,802,591,3,2407,queue,1816
0,803,591,3,2410,queue,1819
0,804,592,3,2413,queue,1821
0,805,593,3,2416,queue,1823
0,806,594,3,2419,queue,1825
0,807,594,3,2422,queue,1828
0,808,595,3,2425,queue,1830
0,809,596,3,2428,queue,1832
0,810,597,3,2431,queue,1834
0,811,597,3,2434,queue,1837
0,812,598,3,2437,queue,1839
0,813,598,3,2440,queue,1842
0,814,599,3,2443,queue,1844
0,815,600,3,2446,queue,1846
0,816,601,3,2449,queue,1848
0,817,601,3,2452,queue,1851
0,818,602,3,2455,queue,1853
0,819,603,3,2458,queue,1855
0,820,604,3,2461,queue,1857
0,821,604,3,2464,queue,1860
0,822,605,3,2467,queue,1862
0,823,606,3,2470,queue,1864
0,824,607,3,2473,queue,1866
0,825,607,3,2476,queue,1869
0,826,608,3,2479,queue,1871
0,827,609,3,2482,queue,1873
0,828,610,3,2485,queue,1875
0,829,610,3,2488,queue,1878
0,830,611,3,2491,queue,1880
0,831,612,3,2494,queue,1882
0,832,613,3,2497,queue,1884
0,833,613,3,2500,queue,1887
0,834,614,3,2503,queue,1889
0,835,615,3,2506,queue,1891
0,836,616,3,2509,queue,1893
0,837,616,3,2512,queue,1896
0,838,617,3,2515,queue,1898
0,839,618,3,2518,queue,1900
0,840,618,3,2521,queue,1903
0,841,619,3,2524,queue,1905
0,842,620,3,2527,queue,1907
0,843,621,3,2530,queue,1909
0,844,621,3,2533,queue,1912
0,845,622,3,2536,queue,1914
0,846,623,3,2539,queue,1916
0,847,624,3,2542,queue,1918
0,848,624,3,2545,queue,1921
0,849,625,3,2548,queue,1923
0,850,626,3,2551,queue,1925
0,851,627,3,2554,queue,1927
0,852,627,3,2557,queue,1930
0,853,628,3,2560,queue,1932
0,854,629,3,2563,queue,1934
0,855,630,3,2566,queue,1936
0,856,630,3,2569,queue,1939
0,857,631,3,2572,queue,1941
0,858,632,3,2575,queue,1943
0,859,633,3,2578,queue,1945
0,860,633,3,2581,queue,1948
0,861,634,3,2584,queue,1950
0,862,634,3,2587,queue,1953
0,863,635,3,2590,queue,1955
0,864,636,3,2593,queue,1957
0,865,637,3,2596,queue,1959
0,866,637,3,2599,queue,1962
0,867,638,3,2602,queue,1964
0,868,639,3,2605,queue,1966
0,869,640,3,2608,queue,1968
0,870,640,3,2611,queue,1971
0,871,641,3,2614,queue,1973
0,872,642,3,2617,queue,1975
0,873,643,3,2620,queue,1977
0,874,643,3,2623,queue,1980
0,875,644,3,2626,queue,1982
0,876,645,3,2629,queue,1984
0,877,646,3,2632,queue,1986
0,878,646,3,2635,queue,1989
0,879,647,3,2638,queue,1991
0,880,648,3,2641,queue,1993
0,881,649,3,2644,queue,1995
0,882,649,3,2647,queue,1998
0,883,650,3,2650,queue,2000
0,884,651,3,2653,queue,2002
0,885,652,3,2656,queue,2004
0,886,652,3,2659,queue,2007
0,887,653,3,2662,queue,2009
0,888,654,3,2665,queue,2011
0,889,654,3,2668,queue,2014
0,890,655,3,2671,queue,2016
0,891,656,3,2674,queue,2018
0,892,657,3,2677,queue,2020
0,893,657,3,2680,queue,2023
0,894,658,3,2683,queue,2025
0,895,659,3,2686,queue,2027
0,896,660,3,2689,queue,2029
0,897,660,3,2692,queue,2032
0,898,661,3,2695,queue,2034
0,899,662,3,2698,queue,2036
0,900,663,3,2701,queue,2038
0,901,663,3,2704,queue,2041
0,902,664,3,2707,queue,2043
0,903,665,3,2710,queue,2045
0,904,666,3,2713,queue,2047
0,905,666,3,2716,queue,2050
0,906,667,3,2719,queue,2052
0,907,668,3,2722,queue,2054
0,908,669,3,2725,queue,2056
0,909,669,3,2728,queue,2059
0,910,670,3,2731,queue,2061
0,911,671,3,2734,queue,2063
0,912,672,3,2737,queue,2065
0,913,672,3,2740,queue,2068
0,914,673,3,2743,queue,2070
0,915,673,3,2746,queue,2073
0,916,674,3,2749,queue,2075
0,917,675,3,2752,queue,2077
0,918,676,3,2755,queue,2079
0,919,676,3,2758,queue,2082
0,920,677,3,2761,queue,2084
0,921,678,3,2764,queue,2086
0,922,679,3,2767,queue,2088
0,923,679,3,2770,queue,2091
0,924,680,3,2773,queue,2093
0,925,681,3,2776,queue,2095
0,926,682,3,2779,queue,2097
0,927,682,3,2782,queue,2100
0,928,683,3,2785,queue,2102
0,929,684,3,2788,queue,2104
0,930,685,3,2791,queue,2106
0,931,685,3,2794,queue,2109
0,932,686,3,2797,queue,2111
0,933,687,3,2800,queue,2113
0,934,688,3,2803,queue,2115
0,935,688,3,2806,queue,2118
0,936,689,3,2809,queue,2120
0,937,690,3,2812,queue,2122
0,938,691,3,2815,queue,2124
0,939,691,3,2818,queue,2127
0,940,692,3,2821,queue,2129
0,941,693,3,2824,queue,2131
0,942,693,3,2827,queue,2134
0,943,694,3,2830,queue,2136
0,944,695,3,2833,queue,2138
0,945,696,3,2836,queue,2140
0,946,696,3,2839,queue,2143
0,947,697,3,2842,queue,2145
0,948,698,3,2845,queue,2147
0,949,699,3,2848,queue,2149
0,950,699,3,2851,queue,2152
0,951,700,3,2854,queue,2154
0,952,701,3,2857,queue,2156
0,953,702,3,2860,queue,2158
0,954,702,3,2863,queue,2161
0,955,703,3,2866,queue,2163
0,956,704,3,2869,queue,2165
0,957,705,3,2872,queue,2167
0,958,705,3,2875,queue,2170
0,959,706,3,2878,queue,2172
0,960,707,3,2881,queue,2174
0,961,708,3,2884,queue,2176
0,962,708,3,2887,queue,2179
0,963,709,3,2890,queue,2181
0,964,710,3,2893,queue,2183
0,965,711,3,2896,queue,2185
0,966,711,3,2899,queue,2188
0,967,712,3,2902,queue,2190
0,968,712,3,2905,queue,2193
0,969,713,3,2908,queue,2195
0,970,714,3,2911,queue,2197
0,971,715,3,2914,queue,2199
0,972,715,3,2917,queue,2202
0,973,716,3,2920,queue,2204
0,974,717,3,2923,queue,2206
0,975,718,3,2926,queue,2208
0,976,718,3,2929,queue,2211
0,977,719,3,2932,queue,2213
0,978,720,3,2935,queue,2215
0,979,721,3,2938,queue,2217
0,980,721,3,2941,queue,2220
0,981,722,3,2944,queue,2222
0,982,723,3,2947,queue,2224
0,983,724,3,2950,queue,2226
0,984,724,3,2953,queue,2229
0,985,725,3,2956,queue,2231
0,986,726,3,2959,queue,2233
0,987,727,3,2962,queue,2235
0,988,727,3,2965,queue,2238
0,989,728,3,2968,queue,2240
0,990,729,3,2971,queue,2242
0,991,730,3,2974,queue,2244
0,992,730,3,2977,queue,2247
0,993,731,3,2980,queue,2249
0,994,732,3,2983,queue,2251
0,995,732,3,2986,queue,2254
0,996,733,3,2989,queue,2256
0,997,734,3,2992,queue,2258
0,998,735,3,2995,queue,2260
0,999,735,3,2998,queue,2263
0,1000,736,3,3001,queue,2265
0,1001,737,3,3004,queue,2267
0,1002,738,3,3007,queue,2269
0,1003,738,3,3010,queue,2272
0,1004,739,3,3013,queue,2274
0,1005,740,3,3016,queue,2276
0,1006,741,3,3019,queue,2278
0,1007,741,3,3022,queue,2281
0,1008,742,3,3025,queue,2283
0,1009,743,3,3028,queue,2285
0,1010,744,3,3031,queue,2287
0,1011,744,3,3034,queue,2290
0,1012,745,3,3037,queue,2292
0,1013,746,3,3040,queue,2294
0,1014,747,3,3043,queue,2296
0,1015,747,3,3046,queue,2299
0,1016,748,3,3049,queue,2301
0,1017,749,3,3052,queue,2303
0,1018,750,3,3055,queue,2305
0,1019,750,3,3058,queue,2308
0,1020,751,3,3061,queue,2310
0,1021,751,3,3064,queue,2313
0,1022,752,3,3067,queue,2315
0,1023,753,3,3070,queue,2317
0,1024,754,3,3073,queue,2319
0,1025,754,3,3076,queue,2322
0,1026,755,3,3079,queue,2324
0,1027,756,3,3082,queue,2326
0,1028,757,3,3085,queue,2328
0,1029,757,3,3088,queue,2331
0,1030,758,3,3091,queue,2333
0,1031,759,3,3094,queue,2335
0,1032,760,3,3097,queue,2337
0,1033,760,3,3100,queue,2340
0,1034,761,3,3103,queue,2342
0,1035,762,3,3106,queue,2344
0,1036,763,3,3109,queue,2346
0,1037,763,3,3112,queue,2349
0,1038,764,3,3115,queue,2351
0,1039,765,3,3118,queue,2353
0,1040,766,3,3121,queue,2355
0,1041,766,3,3124,queue,2358
0,1042,767,3,3127,queue,2360
0,1043,768,3,3130,queue,2362
0,1044,769,3,3133,queue,2364
0,1045,769,3,3136,queue,2367
0,1046,770,3,3139,queue,2369
0,1047,771,3,3142,queue,2371
0,1048,771,3,3145,queue,2374
0,1049,772,3,3148,queue,2376
0,1050,773,3,3151,queue,2378
0,1051,774,3,3154,queue,2380
0,1052,774,3,3157,queue,2383
0,1053,775,3,3160,queue,2385
0,1054,776,3,3163,queue,2387
0,1055,777,3,3166,queue,2389
0,1056,777,3,3169,queue,2392
0,1057,778,3,3172,queue,2394
0,1058,779,3,3175,queue,2396
0,1059,780,3,3178,queue,2398
0,1060,780,3,3181,queue,2401
0,1061,781,3,3184,queue,2403
0,1062,782,3,3187,queue,2405
0,1063,783,3,3190,queue,2407
0,1064,783,3,3193,queue,2410
0,1065,784,3,3196,queue,2412
0,1066,785,3,3199,queue,2414
0,1067,786,3,3202,queue,2416
0,1068,786,3,3205,queue,2419
0,1069,787,3,3208,queue,2421
0,1070,788,3,3211,queue,2423
0,1071,789,3,3214,queue,2425
0,1072,789,3,3217,queue,2428
0,1073,790,3,3220,queue,2430
0,1074,790,3,3223,queue,2433
0,1075,791,3,3226,queue,2435
0,1076,792,3,3229,queue,2437
0,1077,793,3,3232,queue,2439
0,1078,793,3,3235,queue,2442
0,1079,794,3,3238,queue,2444
0,1080,795,3,3241,queue,2446
0,1081,796,3,3244,queue,2448
0,1082,796,3,3247,queue,2451
0,1083,797,3,3250,queue,2453
0,1084,798,3,3253,queue,2455
0,1085,799,3,3256,queue,2457
0,1086,799,3,3259,queue,2460
0,1087,800,3,3262,queue,2462
0,1088,801,3,3265,queue,2464
0,1089,802,3,3268,queue,2466
0,1090,802,3,3271,queue,2469
0,1091,803,3,3274,queue,2471
0,1092,804,3,3277,queue,2473
0,1093,805,3,3280,queue,2475
0,1094,805,3,3283,queue,2478
0,1095,806,3,3286,queue,2480
0,1096,807,3,3289,queue,2482
0,1097,808,3,3292,queue,2484
0,1098,808,3,3295,queue,2487
0,1099,809,3,3298,queue,2489
0,1100,810,3,3301,queue,2491
0,1101,810,3,3304,queue,2494
0,1102,811,3,3307,queue,2496
0,1103,812,3,3310,queue,2498
0,1104,813,3,3313,queue,2500
0,1105,813,3,3316,queue,2503
0,1106,814,3,3319,queue,2505
0,1107,815,3,3322,queue,2507
0,1108,816,3,3325,queue,2509
0,1109,816,3,3328,queue,2512
0,1110,817,3,3331,queue,2514
0,1111,818,3,3334,queue,2516
0,1112,819,3,3337,queue,2518
0,1113,819,3,3340,queue,2521
0,1114,820,3,3343,queue,2523
0,1115,821,3,3346,queue,2525
0,1116,822,3,3349,queue,2527
0,1117,822,3,3352,queue,2530
0,1118,823,3,3355,queue,2532
0,1119,824,3,3358,queue,2534
0,1120,825,3,3361,queue,2536
0,1121,825,3,3364,queue,2539
0,1122,826,3,3367,queue,2541
0,1123,827,3,3370,queue,2543
0,1124,828,3,3373,queue,2545
0,1125,828,3,3376,queue,2548
0,1126,829,3,3379,queue,2550
0,1127,829,3,3382,queue,2553
0,1128,830,3,3385,queue,2555
0,1129,831,3,3388,queue,2557
0,1130,832,3,3391,queue,2559
0,1131,832,3,3394,queue,2562
0,1132,833,3,3397,queue,2564
0,1133,834,3,3400,queue,2566
0,1134,835,3,3403,queue,2568
0,1135,835,3,3406,queue,2571
0,1136,836,3,3409,queue,2573
0,1137,837,3,3412,queue,2575
0,1138,838,3,3415,queue,2577
0,1139,838,3,3418,queue,2580
0,1140,839,3,3421,queue,2582
0,1141,840,3,3424,queue,2584
0,1142,841,3,3427,queue,2586
0,1143,841,3,3430,queue,2589
0,1144,842,3,3433,queue,2591
0,1145,843,3,3436,queue,2593
0,1146,844,3,3439,queue,2595
0,1147,844,3,3442,queue,2598
0,1148,845,3,3445,queue,2600
0,1149,846,3,3448,queue,2602
0,1150,847,3,3451,queue,2604
0,1151,847,3,3454,queue,2607
0,1152,848,3,3457,queue,2609
0,1153,849,3,3460,queue,2611
0,1154,849,3,3463,queue,2614
0,1155,850,3,3466,queue,2616
0,1156,851,3,3469,queue,2618
0,1157,852,3,3472,queue,2620
0,1158,852,3,3475,queue,2623
0,1159,853,3,3478,queue,2625
0,1160,854,3,3481,queue,2627
0,1161,855,3,3484,queue,2629
0,1162,855,3,3487,queue,2632
0,1163,856,3,3490,queue,2634
0,1164,857,3,3493,queue,2636
0,1165,858,3,3496,queue,2638
0,1166,858,3,3499,queue,2641
0,1167,859,3,3502,queue,2643
0,1168,860,3,3505,queue,2645
0,1169,861,3,3508,queue,2647
0,1170,861,3,3511,queue,2650
0,1171,862,3,3514,queue,2652
0,1172,863,3,3517,queue,2654
0,1173,864,3,3520,queue,2656
0,1174,864,3,3523,queue,2659
0,1175,865,3,3526,queue,2661
0,1176,866,3,3529,queue,2663
0,1177,867,3,3532,queue,2665
0,1178,867,3,3535,queue,2668
0,1179,868,3,3538,queue,2670
0,1180,868,3,3541,queue,2673
0,1181,869,3,3544,queue,2675
0,1182,870,3,3547,queue,2677
0,1183,871,3,3550,queue,2679
0,1184,871,3,3553,queue,2682
0,1185,872,3,3556,queue,2684
0,1186,873,3,3559,queue,2686
0,1187,874,3,3562,queue,2688
0,1188,874,3,3565,queue,2691
0,1189,875,3,3568,queue,2693
0,1190,876,3,3571,queue,2695
0,1191,877,3,3574,queue,2697
0,1192,877,3,3577,queue,2700
0,1193,878,3,3580,queue,2702
0,1194,879,3,3583,queue,2704
0,1195,880,3,3586,queue,2706
0,1196,880,3,3589,queue,2709
0,1197,881,3,3592,queue,2711
0,1198,882,3,3595,queue,2713
0,1199,883,3,3598,queue,2715
0,1200,883,3,3601,queue,2718
0,1201,884,3,3604,queue,2720
0,1202,885,3,3607,queue,2722
0,1203,886,3,3610,queue,2724
0,1204,886,3,3613,queue,2727
0,1205,887,3,3616,queue,2729
0,1206,888,3,3619,queue,2731
0,1207,888,3,3622,queue,2734
0,1208,889,3,3625,queue,2736
0,1209,890,3,3628,queue,2738
0,1210,891,3,3631,queue,2740
0,1211,891,3,3634,queue,2743
0,1212,892,3,3637,queue,2745
0,1213,893,3,3640,queue,2747
0,1214,894,3,3643,queue,2749
0,1215,894,3,3646,queue,2752
0,1216,895,3,3649,queue,2754
0,1217,896,3,3652,queue,2756
0,1218,897,3,3655,queue,2758
0,1219,897,3,3658,queue,2761
0,1220,898,3,3661,queue,2763
0,1221,899,3,3664,queue,2765
0,1222,900,3,3667,queue,2767
0,1223,900,3,3670,queue,2770
0,1224,901,3,3673,queue,2772
0,1225,902,3,3676,queue,2774
0,1226,903,3,3679,queue,2776
0,1227,903,3,3682,queue,2779
0,1228,904,3,3685,queue,2781
0,1229,905,3,3688,queue,2783
0,1230,906,3,3691,queue,2785
0,1231,906,3,3694,queue,2788
0,1232,907,3,3697,queue,2790
0,1233,907,3,3700,queue,2793
0,1234,908,3,3703,queue,2795
0,1235,909,3,3706,queue,2797
0,1236,910,3,3709,queue,2799
0,1237,910,3,3712,queue,2802
0,1238,911,3,3715,queue,2804
0,1239,912,3,3718,queue,2806
0,1240,913,3,3721,queue,2808
0,1241,913,3,3724,queue,2811
0,1242,914,3,3727,queue,2813
0,1243,915,3,3730,queue,2815
0,1244,916,3,3733,queue,2817
0,1245,916,3,3736,queue,2820
0,1246,917,3,3739,queue,2822
0,1247,918,3,3742,queue,2824
0,1248,919,3,3745,queue,2826
0,1249,919,3,3748,queue,2829
0,1250,920,3,3751,queue,2831
0,1251,921,3,3754,queue,2833
0,1252,922,3,3757,queue,2835
0,1253,922,3,3760,queue,2838
0,1254,923,3,3763,queue,2840
0,1255,924,3,3766,queue,2842
0,1256,925,3,3769,queue,2844
0,1257,925,3,3772,queue,2847
0,1258,926,3,3775,queue,2849
0,1259,927,3,3778,queue,2851
0,1260,927,3,3781,queue,2854
0,1261,928,3,3784,queue,2856
0,1262,929,3,3787,queue,2858
0,1263,930,3,3790,queue,2860
0,1264,930,3,3793,queue,2863
0,1265,931,3,3796,queue,2865
0,1266,932,3,3799,queue,2867
0,1267,933,3,3802,queue,2869
0,1268,933,3,3805,queue,2872
0,1269,934,3,3808,queue,2874
0,1270,935,3,3811,queue,2876
0,1271,936,3,3814,queue,2878
0,1272,936,3,3817,queue,2881
0,1273,937,3,3820,queue,2883
0,1274,938,3,3823,queue,2885
0,1275,939,3,3826,queue,2887
0,1276,939,3,3829,queue,2890
0,1277,940,3,3832,queue,2892
0,1278,941,3,3835,queue,2894
0,1279,942,3,3838,queue,2896
0,1280,942,3,3841,queue,2899
0,1281,943,3,3844,queue,2901
0,1282,944,3,3847,queue,2903
0,1283,945,3,3850,queue,2905
0,1284,945,3,3853,queue,2908
0,1285,946,3,3856,queue,2910
0,1286,946,3,3859,queue,2913
0,1287,947,3,3862,queue,2915
0,1288,948,3,3865,queue,2917
0,1289,949,3,3868,queue,2919
0,1290,949,3,3871,queue,2922
0,1291,950,3,3874,queue,2924
0,1292,951,3,3877,queue,2926
0,1293,952,3,3880,queue,2928
0,1294,952,3,3883,queue,2931
0,1295,953,3,3886,queue,2933
0,1296,954,3,3889,queue,2935
0,1297,955,3,3892,queue,2937
0,1298,955,3,3895,queue,2940
0,1299,956,3,3898,queue,2942
0,1300,957,3,3901,queue,2944
0,1301,958,3,3904,queue,2946
0,1302,958,3,3907,queue,2949
0,1303,959,3,3910,queue,2951
0,1304,960,3,3913,queue,2953
0,1305,961,3,3916,queue,2955
0,1306,961,3,3919,queue,2958
0,1307,962,3,3922,queue,2960
0,1308,963,3,3925,queue,2962
0,1309,964,3,3928,queue,2964
0,1310,964,3,3931,queue,2967
0,1311,965,3,3934,queue,2969
0,1312,966,3,3937,queue,2971
0,1313,966,3,3940,queue,2974
0,1314,967,3,3943,queue,2976
0,1315,968,3,3946,queue,2978
0,1316,969,3,3949,queue,2980
0,1317,969,3,3952,queue,2983
0,1318,970,3,3955,queue,2985
0,1319,971,3,3958,queue,2987
0,1320,972,3,3961,queue,2989
0,1321,972,3,3964,queue,2992
0,1322,973,3,3967,queue,2994
0,1323,974,3,3970,queue,2996
0,1324,975,3,3973,queue,2998
0,1325,975,3,3976,queue,3001
0,1326,976,3,3979,queue,3003
0,1327,977,3,3982,queue,3005
0,1328,978,3,3985,queue,3007
0,1329,978,3,3988,queue,3010
0,1330,979,3,3991,queue,3012
0,1331,980,3,3994,queue,3014
0,1332,981,3,3997,queue,3016
0,1333,981,3,4000,queue,3019
0,1334,982,3,4003,queue,3021
0,1335,983,3,4006,queue,3023
0,1336,984,3,4009,queue,3025
0,1337,984,3,4012,queue,3028
0,1338,985,3,4015,queue,3030
0,1339,985,3,4018,queue,3033
0,1340,986,3,4021,queue,3035
0,1341,987,3,4024,queue,3037
0,1342,988,3,4027,queue,3039
0,1343,988,3,4030,queue,3042
0,1344,989,3,4033,queue,3044
0,1345,990,3,4036,queue,3046
0,1346,991,3,4039,queue,3048
0,1347,991,3,4042,queue,3051
0,1348,992,3,4045,queue,3053
0,1349,993,3,4048,queue,3055
0,1350,994,3,4051,queue,3057
0,1351,994,3,4054,queue,3060
0,1352,995,3,4057,queue,3062
0,1353,996,3,4060,queue,3064
0,1354,997,3,4063,queue,3066
0,1355,997,3,4066,queue,3069
0,1356,998,3,4069,queue,3071
1,1358,1,3,4,line,3
1,1359,2,3,7,line,5
1,1360,4,3,10,line,6
1,1361,5,3,13,line,8
1,1362,7,3,16,line,9
1,1363,8,3,19,line,11
1,1364,10,3,22,line,12
1,1365,11,3,25,line,14
1,1366,14,3,28,line,14
1,1367,15,3,31,line,16
1,1368,17,3,34,line,17
1,1369,18,3,37,line,19
1,1370,20,3,40,line,20
1,1371,21,3,43,line,22
1,1372,23,3,46,line,23
1,1373,24,3,49,line,25
1,1374,26,3,52,line,26
1,1375,27,3,55,line,28
1,1376,29,3,58,line,29
1,1377,31,3,61,line,30
1,1378,32,3,64,line,32
1,1379,34,3,67,line,33
1,1380,35,3,70,line,35
1,1381,37,3,73,line,36
1,1382,38,3,76,line,38
1,1383,40,3,79,line,39
1,1384,41,3,82,line,41
1,1385,43,3,85,line,42
1,1386,44,3,88,line,44
1,1387,46,3,91,line,45
1,1388,47,3,94,line,47
1,1389,50,3,97,line,47
1,1390,51,3,100,line,49
1,1391,53,3,103,line,50
1,1392,54,3,106,line,52
1,1393,56,3,109,line,53
1,1394,57,3,112,line,55
1,1395,59,3,115,line,56
1,1396,60,3,118,line,58
1,1397,62,3,121,line,59
1,1398,63,3,124,line,61
1,1399,65,3,127,line,62
1,1400,66,3,130,line,64
1,1401,68,3,133,line,65
1,1402,70,3,136,line,66
1,1403,71,3,139,line,68
1,1404,73,3,142,line,69
1,1405,74,3,145,line,71
1,1406,76,3,148,line,72
1,1407,77,3,151,line,74
1,1408,79,3,154,line,75
1,1409,80,3,157,line,77
1,1410,82,3,160,line,78
1,1411,83,3,163,line,80
1,1412,85,3,166,line,81
1,1413,86,3,169,line,83
1,1414,89,3,172,line,83
1,1415,90,3,175,line,85
1,1416,92,3,178,line,86
1,1417,93,3,181,line,88
1,1418,95,3,184,line,89
1,1419,96,3,187,line,91
1,1420,98,3,190,line,92
1,1421,99,3,193,line,94
1,1422,101,3,196,line,95
1,1423,102,3,199,line,97
1,1424,104,3,202,line,98
1,1425,105,3,205,line,100
1,1426,107,3,208,line,101
1,1427,109,3,211,line,102
1,1428,110,3,214,line,104
1,1429,112,3,217,line,105
1,1430,113,3,220,line,107
1,1431,115,3,223,line,108
1,1432,116,3,226,line,110
1,1433,118,3,229,line,111
1,1434,119,3,232,line,113
1,1435,121,3,235,line,114
1,1436,122,3,238,line,116
1,1437,124,3,241,line,117
1,1438,125,3,244,line,119
1,1439,128,3,247,line,119
1,1440,129,3,250,line,121
1,1441,131,3,253,line,122
1,1442,132,3,256,line,124
1,1443,134,3,259,line,125
1,1444,135,3,262,line,127
1,1445,137,3,265,line,128
1,1446,138,3,268,line,130
1,1447,140,3,271,line,131
1,1448,141,3,274,line,133
1,1449,143,3,277,line,134
1,1450,144,3,280,line,136
1,1451,146,3,283,line,137
1,1452,147,3,286,line,139
1,1453,149,3,289,line,140
1,1454,151,3,292,line,141
1,1455,152,3,295,line,143
1,1456,154,3,298,line,144
1,1457,155,3,301,line,146
1,1458,157,3,304,line,147
1,1459,158,3,307,line,149
1,1460,160,3,310,line,150
1,1461,161,3,313,line,152
1,1462,163,3,316,line,153
1,1463,164,3,319,line,155
1,1464,167,3,322,line,155
1,1465,168,3,325,line,157
1,1466,170,3,328,line,158
1,1467,171,3,331,line,160
1,1468,173,3,334,line,161
1,1469,174,3,337,line,163
1,1470,176,3,340,line,164
1,1471,177,3,343,line,166
1,1472,179,3,346,line,167
1,1473,180,3,349,line,169
1,1474,182,3,352,line,170
1,1475,183,3,355,line,172
1,1476,185,3,358,line,173
1,1477,187,3,361,line,174
1,1478,188,3,364,line,176
1,1479,190,3,367,line,177
1,1480,191,3,370,line,179
1,1481,193,3,373,line,180
1,1482,194,3,376,line,182
1,1483,196,3,379,line,183
1,1484,197,3,382,line,185
1,1485,199,3,385,line,186
1,1486,200,3,388,line,188
1,1487,202,3,391,line,189
1,1488,203,3,394,line,191
1,1489,206,3,397,line,191
1,1490,207,3,400,line,193
1,1491,209,3,403,line,194
1,1492,210,3,406,line,196
1,1493,212,3,409,line,197
1,1494,213,3,412,line,199
1,1495,215,3,415,line,200
1,1496,216,3,418,line,202
1,1497,218,3,421,line,203
1,1498,219,3,424,line,205
1,1499,221,3,427,line,206
1,1500,222,3,430,line,208
1,1501,224,3,433,line,209
1,1502,226,3,436,line,210
1,1503,227,3,439,line,212
1,1504,229,3,442,line,213
1,1505,230,3,445,line,215
1,1506,232,3,448,line,216
1,1507,233,3,451,line,218
1,1508,235,3,454,line,219
1,1509,236,3,457,line,221
1,1510,238,3,460,line,222
1,1511,239,3,463,line,224
1,1512,241,3,466,line,225
1,1513,242,3,469,line,227
1,1514,245,3,472,line,227
1,1515,246,3,475,line,229
1,1516,248,3,478,line,230
1,1517,249,3,481,line,232
1,1518,251,3,484,line,233
1,1519,252,3,487,line,235
1,1520,254,3,490,line,236
1,1521,255,3,493,line,238
1,1522,257,3,496,line,239
1,1523,258,3,499,line,241
1,1524,260,3,502,line,242
1,1525,261,3,505,line,244
1,1526,263,3,508,line,245
1,1527,265,3,511,line,246
1,1528,266,3,514,line,248
1,1529,268,3,517,line,249
1,1530,269,3,520,line,251
1,1531,271,3,523,line,252
1,1532,272,3,526,line,254
1,1533,274,3,529,line,255
1,1534,275,3,532,line,257
1,1535,277,3,535,line,258
1,1536,278,3,538,line,260
1,1537,280,3,541,line,261
1,1538,281,3,544,line,263
1,1539,283,3,547,line,264
1,1540,284,3,550,line,266
1,1541,287,3,553,line,266
1,1542,288,3,556,line,268
1,1543,290,3,559,line,269
1,1544,291,3,562,line,271
1,1545,293,3,565,line,272
1,1546,294,3,568,line,274
1,1547,296,3,571,line,275
1,1548,297,3,574,line,277
1,1549,299,3,577,line,278
1,1550,300,3,580,line,280
1,1551,302,3,583,line,281
1,1552,303,3,586,line,283
1,1553,305,3,589,line,284
1,1554,307,3,592,line,285
1,1555,308,3,595,line,287
1,1556,310,3,598,line,288
1,1557,311,3,601,line,290
1,1558,313,3,604,line,291
1,1559,314,3,607,line,293
1,1560,316,3,610,line,294
1,1561,317,3,613,line,296
1,1562,319,3,616,line,297
1,1563,320,3,619,line,299
1,1564,323,3,622,line,299
1,1565,324,3,625,line,301
1,1566,326,3,628,line,302
1,1567,327,3,631,line,304
1,1568,329,3,634,line,305
1,1569,330,3,637,line,307
1,1570,332,3,640,line,308
1,1571,333,3,643,line,310
1,1572,335,3,646,line,311
1,1573,336,3,649,line,313
1,1574,338,3,652,line,314
1,1575,339,3,655,line,316
1,1576,341,3,658,line,317
1,1577,343,3,661,line,318
1,1578,344,3,664,line,320
1,1579,346,3,667,line,321
1,1580,347,3,670,line,323
1,1581,349,3,673,line,324
1,1582,350,3,676,line,326
1,1583,352,3,679,line,327
1,1584,353,3,682,line,329
1,1585,355,3,685,line,330
1,1586,356,3,688,line,332
1,1587,358,3,691,line,333
1,1588,359,3,694,line,335
1,1589,362,3,697,line,335
1,1590,363,3,700,line,337
1,1591,365,3,703,line,338
1,1592,366,3,706,line,340
1,1593,368,3,709,line,341
1,1594,369,3,712,line,343
1,1595,371,3,715,line,344
1,1596,372,3,718,line,346
1,1597,374,3,721,line,347
1,1598,375,3,724,line,349
1,1599,377,3,727,line,350
1,1600,378,3,730,line,352
1,1601,380,3,733,line,353
1,1602,382,3,736,line,354
1,1603,383,3,739,line,356
1,1604,385,3,742,line,357
1,1605,386,3,745,line,359
1,1606,388,3,748,line,360
1,1607,389,3,751,line,362
1,1608,391,3,754,line,363
1,1609,392,3,757,line,365
1,1610,394,3,760,line,366
1,1611,395,3,763,line,368
1,1612,397,3,766,line,369
1,1613,398,3,769,line,371
1,1614,401,3,772,line,371
1,1615,402,3,775,line,373
1,1616,404,3,778,line,374
1,1617,405,3,781,line,376
1,1618,407,3,784,line,377
1,1619,408,3,787,line,379
1,1620,410,3,790,line,380
1,1621,411,3,793,line,382
1,1622,413,3,796,line,383
1,1623,414,3,799,line,385
1,1624,416,3,802,line,386
1,1625,417,3,805,line,388
1,1626,419,3,808,line,389
1,1627,421,3,811,line,390
1,1628,422,3,814,line,392
1,1629,424,3,817,line,393
1,1630,425,3,820,line,395
1,1631,427,3,823,line,396
1,1632,428,3,826,line,398
1,1633,430,3,829,line,399
1,1634,431,3,832,line,401
1,1635,433,3,835,line,402
1,1636,434,3,838,line,404
1,1637,436,3,841,line,405
1,1638,437,3,844,line,407
1,1639,440,3,847,line,407
1,1640,441,3,850,line,409
1,1641,443,3,853,line,410
1,1642,444,3,856,line,412
1,1643,446,3,859,line,413
1,1644,447,3,862,line,415
1,1645,449,3,865,line,416
1,1646,450,3,868,line,418
1,1647,452,3,871,line,419
1,1648,453,3,874,line,421
1,1649,455,3,877,line,422
1,1650,456,3,880,line,424
1,1651,458,3,883,line,425
1,1652,460,3,886,line,426
1,1653,461,3,889,line,428
1,1654,463,3,892,line,429
1,1655,464,3,895,line,431
1,1656,466,3,898,line,432
1,1657,467,3,901,line,434
1,1658,469,3,904,line,435
1,1659,470,3,907,line,437
1,1660,472,3,910,line,438
1,1661,473,3,913,line,440
1,1662,475,3,916,line,441
1,1663,476,3,919,line,443
1,1664,479,3,922,line,443
1,1665,480,3,925,line,445
1,1666,482,3,928,line,446
1,1667,483,3,931,line,448
1,1668,485,3,934,line,449
1,1669,486,3,937,line,451
1,1670,488,3,940,line,452
1,1671,489,3,943,line,454
1,1672,491,3,946,line,455
1,1673,492,3,949,line,457
1,1674,494,3,952,line,458
1,1675,495,3,955,line,460
1,1676,497,3,958,line,461
1,1677,499,3,961,line,462
1,1678,500,3,964,line,464
1,1679,502,3,967,line,465
1,1680,503,3,970,line,467
1,1681,505,3,973,line,468
1,1682,506,3,976,line,470
1,1683,508,3,979,line,471
1,1684,509,3,982,line,473
1,1685,511,3,985,line,474
1,1686,512,3,988,line,476
1,1687,514,3,991,line,477
1,1688,515,3,994,line,479
1,1689,518,3,997,line,479
1,1690,519,3,1000,line,481
1,1691,521,3,1003,line,482
1,1692,522,3,1006,line,484
1,1693,524,3,1009,line,485
1,1694,525,3,1012,line,487
1,1695,527,3,1015,line,488
1,1696,528,3,1018,line,490
1,1697,530,3,1021,line,491
1,1698,531,3,1024,line,493
1,1699,533,3,1027,line,494
1,1700,534,3,1030,line,496
1,1701,536,3,1033,line,497
1,1702,538,3,1036,line,498
1,1703,539,3,1039,line,500
1,1704,541,3,1042,line,501
1,1705,542,3,1045,line,503
1,1706,544,3,1048,line,504
1,1707,545,3,1051,line,506
1,1708,547,3,1054,line,507
1,1709,548,3,1057,line,509
1,1710,550,3,1060,line,510
1,1711,551,3,1063,line,512
1,1712,553,3,1066,line,513
1,1713,554,3,1069,line,515
1,1714,556,3,1072,line,516
1,1715,557,3,1075,line,518
1,1716,560,3,1078,line,518
1,1717,561,3,1081,line,520
1,1718,563,3,1084,line,521
1,1719,564,3,1087,line,523
1,1720,566,3,1090,line,524
1,1721,567,3,1093,line,526
1,1722,569,3,1096,line,527
1,1723,570,3,1099,line,529
1,1724,572,3,1102,line,530
1,1725,573,3,1105,line,532
1,1726,575,3,1108,line,533
1,1727,576,3,1111,line,535
1,1728,578,3,1114,line,536
1,1729,580,3,1117,line,537
1,1730,581,3,1120,line,539
1,1731,583,3,1123,line,540
1,1732,584,3,1126,line,542
1,1733,586,3,1129,line,543
1,1734,587,3,1132,line,545
1,1735,589,3,1135,line,546
1,1736,590,3,1138,line,548
1,1737,592,3,1141,line,549
1,1738,593,3,1144,line,551
1,1739,595,3,1147,line,552
1,1740,596,3,1150,line,554
1,1741,599,3,1153,line,554
1,1742,600,3,1156,line,556
1,1743,602,3,1159,line,557
1,1744,603,3,1162,line,559
1,1745,605,3,1165,line,560
1,1746,606,3,1168,line,562
1,1747,608,3,1171,line,563
1,1748,609,3,1174,line,565
1,1749,611,3,1177,line,566
1,1750,612,3,1180,line,568
1,1751,614,3,1183,line,569
1,1752,615,3,1186,line,571
1,1753,617,3,1189,line,572
1,1754,619,3,1192,line,573
1,1755,620,3,1195,line,575
1,1756,622,3,1198,line,576
1,1757,623,3,1201,line,578
1,1758,625,3,1204,line,579
1,1759,626,3,1207,line,581
1,1760,628,3,1210,line,582
1,1761,629,3,1213,line,584
1,1762,631,3,1216,line,585
1,1763,632,3,1219,line,587
1,1764,635,3,1222,line,587
1,1765,636,3,1225,line,589
1,1766,638,3,1228,line,590
1,1767,639,3,1231,line,592
1,1768,641,3,1234,line,593
1,1769,642,3,1237,line,595
1,1770,644,3,1240,line,596
1,1771,645,3,1243,line,598
1,1772,647,3,1246,line,599
1,1773,648,3,1249,line,601
1,1774,650,3,1252,line,602
1,1775,651,3,1255,line,604
1,1776,653,3,1258,line,605
1,1777,655,3,1261,line,606
1,1778,656,3,1264,line,608
1,1779,658,3,1267,line,609
1,1780,659,3,1270,line,611
1,1781,661,3,1273,line,612
1,1782,662,3,1276,line,614
1,1783,664,3,1279,line,615
1,1784,665,3,1282,line,617
1,1785,667,3,1285,line,618
1,1786,668,3,1288,line,620
1,1787,670,3,1291,line,621
1,1788,671,3,1294,line,623
1,1789,674,3,1297,line,623
1,1790,675,3,1300,line,625
1,1791,677,3,1303,line,626
1,1792,678,3,1306,line,628
1,1793,680,3,1309,line,629
1,1794,681,3,1312,line,631
1,1795,683,3,1315,line,632
1,1796,684,3,1318,line,634
1,1797,686,3,1321,line,635
1,1798,687,3,1324,line,637
1,1799,689,3,1327,line,638
1,1800,690,3,1330,line,640
1,1801,692,3,1333,line,641
1,1802,694,3,1336,line,642
1,1803,695,3,1339,line,644
1,1804,697,3,1342,line,645
1,1805,698,3,1345,line,647
1,1806,700,3,1348,line,648
1,1807,701,3,1351,line,650
1,1808,703,3,1354,line,651
1,1809,704,3,1357,line,653
1,1810,706,3,1360,line,654
1,1811,707,3,1363,line,656
1,1812,709,3,1366,line,657
1,1813,710,3,1369,line,659
1,1814,713,3,1372,line,659
1,1815,714,3,1375,line,661
1,1816,716,3,1378,line,662
1,1817,717,3,1381,line,664
1,1818,719,3,1384,line,665
1,1819,720,3,1387,line,667
1,1820,722,3,1390,line,668
1,1821,723,3,1393,line,670
1,1822,725,3,1396,line,671
1,1823,726,3,1399,line,673
1,1824,728,3,1402,line,674
1,1825,729,3,1405,line,676
1,1826,731,3,1408,line,677
1,1827,733,3,1411,line,678
1,1828,734,3,1414,line,680
1,1829,736,3,1417,line,681
1,1830,737,3,1420,line,683
1,1831,739,3,1423,line,684
1,1832,740,3,1426,line,686
1,1833,742,3,1429,line,687
1,1834,743,3,1432,line,689
1,1835,745,3,1435,line,690
1,1836,746,3,1438,line,692
1,1837,748,3,1441,line,693
1,1838,749,3,1444,line,695
1,1839,752,3,1447,line,695
1,1840,753,3,1450,line,697
1,1841,755,3,1453,line,698
1,1842,756,3,1456,line,700
1,1843,758,3,1459,line,701
1,1844,759,3,1462,line,703
1,1845,761,3,1465,line,704
1,1846,762,3,1468,line,706
1,1847,764,3,1471,line,707
1,1848,765,3,1474,line,709
1,1849,767,3,1477,line,710
1,1850,768,3,1480,line,712
1,1851,770,3,1483,line,713
1,1852,772,3,1486,line,714
1,1853,773,3,1489,line,716
1,1854,775,3,1492,line,717
1,1855,776,3,1495,line,719
1,1856,778,3,1498,line,720
1,1857,779,3,1501,line,722
1,1858,781,3,1504,line,723
1,1859,782,3,1507,line,725
1,1860,784,3,1510,line,726
1,1861,785,3,1513,line,728
1,1862,787,3,1516,line,729
1,1863,788,3,1519,line,731
1,1864,791,3,1522,line,731
1,1865,792,3,1525,line,733
1,1866,794,3,1528,line,734
1,1867,795,3,1531,line,736
1,1868,797,3,1534,line,737
1,1869,798,3,1537,line,739
1,1870,800,3,1540,line,740
1,1871,801,3,1543,line,742
1,1872,803,3,1546,line,743
1,1873,804,3,1549,line,745
1,1874,806,3,1552,line,746
1,1875,807,3,1555,line,748
1,1876,809,3,1558,line,749
1,1877,811,3,1561,line,750
1,1878,812,3,1564,line,752
1,1879,814,3,1567,line,753
1,1880,815,3,1570,line,755
1,1881,817,3,1573,line,756
1,1882,818,3,1576,line,758
1,1883,820,3,1579,line,759
1,1884,821,3,1582,line,761
1,1885,823,3,1585,line,762
1,1886,824,3,1588,line,764
1,1887,826,3,1591,line,765
1,1888,827,3,1594,line,767
1,1889,830,3,1597,line,767
1,1890,831,3,1600,line,769
1,1891,833,3,1603,line,770
1,1892,834,3,1606,line,772
1,1893,836,3,1609,line,773
1,1894,837,3,1612,line,775
1,1895,839,3,1615,line,776
1,1896,840,3,1618,line,778
1,1897,842,3,1621,line,779
1,1898,843,3,1624,line,781
1,1899,845,3,1627,line,782
1,1900,846,3,1630,line,784
1,1901,848,3,1633,line,785
1,1902,850,3,1636,line,786
1,1903,851,3,1639,line,788
1,1904,853,3,1642,line,789
1,1905,854,3,1645,line,791
1,1906,856,3,1648,line,792
1,1907,857,3,1651,line,794
1,1908,859,3,1654,line,795
1,1909,860,3,1657,line,797
1,1910,862,3,1660,line,798
1,1911,863,3,1663,line,800
1,1912,865,3,1666,line,801
1,1913,866,3,1669,line,803
1,1914,869,3,1672,line,803
1,1915,870,3,1675,line,805
1,1916,872,3,1678,line,806
1,1917,873,3,1681,line,808
1,1918,875,3,1684,line,809
1,1919,876,3,1687,line,811
1,1920,878,3,1690,line,812
1,1921,879,3,1693,line,814
1,1922,881,3,1696,line,815
1,1923,882,3,1699,line,817
1,1924,884,3,1702,line,818
1,1925,885,3,1705,line,820
1,1926,887,3,1708,line,821
1,1927,889,3,1711,line,822
1,1928,890,3,1714,line,824
1,1929,892,3,1717,line,825
1,1930,893,3,1720,line,827
1,1931,895,3,1723,line,828
1,1932,896,3,1726,line,830
1,1933,898,3,1729,line,831
1,1934,899,3,1732,line,833
1,1935,901,3,1735,line,834
1,1936,902,3,1738,line,836
1,1937,904,3,1741,line,837
1,1938,905,3,1744,line,839
1,1939,908,3,1747,line,839
1,1940,909,3,1750,line,841
1,1941,911,3,1753,line,842
1,1942,912,3,1756,line,844
1,1943,914,3,1759,line,845
1,1944,915,3,1762,line,847
1,1945,917,3,1765,line,848
1,1946,918,3,1768,line,850
1,1947,920,3,1771,line,851
1,1948,921,3,1774,line,853
1,1949,923,3,1777,line,854
1,1950,924,3,1780,line,856
1,1951,926,3,1783,line,857
1,1952,928,3,1786,line,858
1,1953,929,3,1789,line,860
1,1954,931,3,1792,line,861
1,1955,932,3,1795,line,863
1,1956,934,3,1798,line,864
1,1957,935,3,1801,line,866
1,1958,937,3,1804,line,867
1,1959,938,3,1807,line,869
1,1960,940,3,1810,line,870
1,1961,941,3,1813,line,872
1,1962,943,3,1816,line,873
1,1963,944,3,1819,line,875
1,1964,947,3,1822,line,875
1,1965,948,3,1825,line,877
1,1966,950,3,1828,line,878
1,1967,951,3,1831,line,880
1,1968,953,3,1834,line,881
1,1969,954,3,1837,line,883
1,1970,956,3,1840,line,884
1,1971,957,3,1843,line,886
1,1972,959,3,1846,line,887
1,1973,960,3,1849,line,889
1,1974,962,3,1852,line,890
1,1975,963,3,1855,line,892
1,1976,965,3,1858,line,893
1,1977,967,3,1861,line,894
1,1978,968,3,1864,line,896
1,1979,970,3,1867,line,897
1,1980,971,3,1870,line,899
1,1981,973,3,1873,line,900
1,1982,974,3,1876,line,902
1,1983,976,3,1879,line,903
1,1984,977,3,1882,line,905
1,1985,979,3,1885,line,906
1,1986,980,3,1888,line,908
1,1987,982,3,1891,line,909
1,1988,983,3,1894,line,911
1,1989,986,3,1897,line,911
1,1990,987,3,1900,line,913
1,1991,989,3,1903,line,914
1,1992,990,3,1906,line,916
1,1993,992,3,1909,line,917
1,1994,993,3,1912,line,919
1,1995,995,3,1915,line,920
1,1996,996,3,1918,line,922
1,1997,998,3,1921,line,923
1,1998,999,3,1924,line,925
